[
  {
    "name": "Level 1",
    "level_data":[
      [0, 0, 0, 0, 0, 0, 0, 0, 0],
      [0, 0, 0, 0, 0, 0, 0, 0, 0],
      [0, 0, 0, 0, 0, 0, 0, 0, 0],
      [0, 0, 0, 0, 0, 0, 0, 0, 0],
      [0, 0, 1, 0, 1, 0, 1, 0, 0],
      [0, 0, 1, 0, 1, 0, 1, 0, 0]
    ]
  },
  {
    "name": "Level 2",
    "level_data":[
      [0, 0, 0, 0, 0, 0, 0, 0, 0],
      [0, 1, 0, 1, 0, 1, 1, 1, 0],
      [0, 1, 0, 1, 0, 0, 1, 0, 0],
      [0, 1, 1, 1, 0, 0, 1, 0, 0],
      [0, 1, 0, 1, 0, 0, 1, 0, 0],
      [0, 1, 0, 1, 0, 1, 1, 1, 0]
    ]
  },
  {
    "name": "Level 3",
    "level_data":[
      [0, 0, 3, 3, 3, 3, 3, 0, 0],
      [0, 0, 0, 0, 0, 3, 3, 0, 0],
      [0, 0, 3, 3, 3, 3, 3, 0, 0],
      [0, 0, 3, 3, 3, 3, 3, 0, 0],
      [0, 0, 0, 0, 0, 3, 3, 0, 0],
      [0, 0, 3, 3, 3, 3, 3, 0, 0]
    ]
  },
  {
    "name": "Level 4",
    "level_data":[
      [1, 2, 3, 4, 5, 4, 3, 2, 1],
      [1, 2, 3, 4, 5, 4, 3, 2, 1],
      [1, 2, 3, 4, 5, 4, 3, 2, 1],
      [1, 2, 3, 4, 5, 4, 3, 2, 1],
      [1, 2, 3, 4, 5, 4, 3, 2, 1],
      [1, 2, 3, 4, 5, 4, 3, 2, 1]
    ]
  }
]